2	2	2	2	2	2	2	2	2	2	2	2	2	2	2
2	1	1	1	1	1	1	1	1	1	1	2	2	2	2
2	1	2	2	2	2	2	2	2	2	1	2	2	2	2
2	1	2	2	2	2	2	2	2	2	1	2	2	2	2
2	1	2	2	2	2	2	2	2	2	1	2	2	2	2
2	1	2	2	2	2	2	2	2	2	1	2	2	2	2
2	10	2	2	2	2	2	2	2	2	1	2	2	2	2
2	2	2	2	2	2	2	2	2	2	1	2	2	2	2
0	0	0	0	0	0	0	0	0	2	3	2	0	0	0
0	0	0	0	0	0	0	0	0	2	3	2	0	0	0
0	0	0	0	0	0	0	0	0	2	3	2	0	0	0
0	0	0	0	0	0	0	0	0	2	3	2	0	0	0
0	0	0	0	0	0	0	0	0	2	3	2	0	0	0
0	0	0	0	0	0	0	0	0	2	3	2	0	0	0
0	0	0	0	0	0	0	0	2	2	1	2	2	2	2
0	0	0	0	0	0	0	0	2	2	1	2	2	2	2
0	0	0	0	0	0	0	0	2	2	1	2	2	2	2
0	0	0	0	0	0	0	0	2	2	1	1	1	1	2
2	2	2	2	2	2	2	2	2	2	2	2	2	1	2
2	2	2	2	2	2	2	2	2	2	2	2	2	1	2
2	2	1	1	1	1	1	1	1	1	1	1	1	1	2
2	2	1	2	2	2	2	2	2	2	2	2	2	2	2
2	2	1	2	2	2	2	2	2	2	2	2	2	2	2
2	2	1	2	2	2	2	2	2	2	2	2	2	2	2
2	2	1	2	2	2	2	2	2	2	2	2	2	2	2
2	2	1	1	1	1	2	2	2	2	2	2	2	2	2
2	2	2	2	2	1	2	2	2	2	2	2	2	2	2
2	2	2	2	2	1	2	2	2	2	2	2	2	2	2
2	2	2	4	4	5	4	4	2	2	2	2	2	2	2
0	0	0	0	0	6	0	0	0	0	0	0	0	0	0