2	2	2	2	2	2	2	2	2	2	2	2	2	2	2	2	2	2	2	2
2	1	1	1	2	2	2	2	2	2	2	2	2	2	2	2	2	2	2	2
2	1	2	1	2	2	2	2	2	2	2	2	2	2	1	1	1	1	1	2
2	1	2	1	2	2	2	2	2	2	2	2	2	2	1	2	2	2	1	2
2	1	2	1	2	2	10	1	1	2	2	2	2	2	1	2	2	2	1	2
2	1	2	1	2	2	2	2	1	2	2	2	1	1	1	1	1	1	1	2
2	1	2	1	2	2	2	2	1	2	2	2	1	2	1	2	2	2	2	2
2	1	1	1	1	1	1	1	1	2	2	2	1	2	1	2	2	2	2	2
2	2	2	1	2	2	2	2	2	2	2	2	1	1	1	1	1	1	2	2
2	2	2	1	2	2	2	2	2	2	2	2	2	2	1	2	2	1	2	2
2	2	2	1	2	2	2	2	2	2	2	2	1	1	1	1	1	1	2	2
2	2	2	1	2	2	2	2	2	2	2	2	1	2	1	2	2	2	2	2
2	2	2	1	2	2	2	2	2	2	2	2	1	2	1	2	2	2	2	2
2	2	2	1	3	3	3	3	3	3	3	3	1	1	1	2	2	2	2	2
2	2	2	2	2	2	2	2	2	2	2	2	1	2	2	2	2	0	0	0
0	0	0	0	0	0	0	0	0	0	0	2	1	2	2	2	2	0	0	0
0	0	0	0	0	0	0	0	0	0	0	2	1	2	2	2	2	0	0	0
0	0	0	0	0	0	0	0	0	0	0	2	1	2	2	2	2	0	0	0
0	0	0	0	0	0	0	0	0	2	2	2	1	2	2	2	2	0	0	0
0	0	0	0	0	0	0	0	0	2	2	2	1	2	2	2	2	0	0	0
0	0	0	0	0	0	0	0	0	4	2	2	1	2	2	2	2	0	0	0
0	0	0	0	0	0	0	0	0	4	2	2	1	2	2	2	2	0	0	0
0	0	0	0	0	0	0	0	6	5	1	1	1	2	2	2	2	0	0	0
0	0	0	0	0	0	0	0	0	4	2	2	2	2	2	2	2	0	0	0
0	0	0	0	0	0	0	0	0	4	2	2	2	2	2	2	2	0	0	0
0	0	0	0	0	0	0	0	0	2	2	2	2	2	2	2	2	0	0	0