2	2	2	2	2	2	2	2	2	0	0	0	0	0	0	0	0	0	2	2	2	2	2	2	2	2
2	2	1	1	1	1	1	1	2	0	0	0	0	0	0	0	0	0	2	2	2	2	2	2	2	2
2	2	1	2	2	2	2	1	2	0	0	0	0	0	0	0	0	0	2	1	1	1	1	1	1	2
2	2	1	2	0	0	2	1	2	0	0	0	0	0	0	0	0	0	2	1	2	2	2	2	1	2
2	2	1	2	0	0	2	3	2	0	0	0	0	0	0	0	0	0	2	1	2	2	2	2	1	2
2	2	1	2	0	0	2	3	2	0	0	0	0	0	0	0	0	0	2	1	2	2	2	2	1	2
2	2	1	2	0	0	2	3	2	0	0	0	0	0	0	0	0	0	2	1	2	2	2	2	1	2
2	2	1	2	0	0	2	3	2	0	0	0	0	0	0	0	0	0	2	1	2	2	2	2	1	2
2	2	10	2	0	0	2	3	2	0	0	0	0	0	0	0	0	0	2	1	2	2	2	2	1	2
2	2	2	2	0	0	2	3	2	0	0	0	0	0	0	0	0	0	2	1	2	2	2	2	1	2
0	0	0	0	0	0	2	3	2	0	0	0	0	0	0	0	0	0	2	1	2	0	0	2	3	2
0	0	0	0	0	0	2	3	2	0	0	0	0	0	0	0	0	0	2	1	2	0	0	2	3	2
0	0	0	0	0	0	2	3	2	0	0	0	0	0	0	0	0	0	2	1	2	0	0	2	3	2
0	0	0	0	0	0	2	1	2	0	0	0	0	0	0	0	0	0	2	1	2	0	0	2	3	2
0	0	0	0	0	0	2	1	2	0	0	0	0	0	0	0	0	0	2	1	2	0	0	2	3	2
0	0	0	0	0	0	2	1	2	0	0	0	0	0	0	0	0	0	2	1	2	0	0	2	3	2
0	0	0	0	0	0	2	1	2	0	0	0	0	0	0	0	0	0	2	1	2	0	0	2	3	2
0	0	0	0	0	0	2	1	2	2	2	2	2	2	2	2	2	2	2	1	2	0	0	2	3	2
0	0	0	0	0	0	2	1	1	1	1	1	1	1	1	1	1	1	1	1	2	0	0	2	3	2
0	0	0	0	0	0	2	2	2	2	2	2	2	2	2	2	2	2	2	2	2	0	0	2	3	2
0	0	0	0	0	0	0	0	0	0	0	0	0	0	0	0	0	0	0	0	0	0	0	2	3	2
0	0	0	0	0	0	0	0	0	0	0	0	0	0	0	0	0	0	0	0	0	0	0	2	3	2
0	0	0	0	0	0	0	0	0	0	0	0	0	0	0	0	0	0	0	0	0	0	0	2	3	2
0	0	0	0	0	0	0	0	0	0	0	0	0	0	0	0	0	0	0	0	0	0	0	2	3	2
0	0	0	0	0	0	0	0	0	0	0	0	0	0	0	0	0	0	0	0	0	0	0	2	3	2
0	0	0	0	0	0	0	0	0	0	0	0	0	0	0	0	0	0	0	0	0	0	0	2	3	2
0	0	0	0	0	0	0	0	0	0	0	0	0	0	0	0	0	0	0	0	0	0	0	2	3	2
0	0	0	0	0	0	0	0	0	0	0	0	0	0	0	0	0	0	0	0	0	0	0	2	3	2
0	0	0	0	0	0	0	0	0	0	0	0	0	0	0	0	0	0	0	0	0	0	0	2	3	2
0	0	0	0	0	0	0	0	0	0	0	0	0	0	0	0	0	0	0	0	0	0	0	2	3	2
0	0	0	0	0	0	0	0	0	0	0	0	0	0	0	0	0	0	0	0	0	0	0	2	3	2
0	0	0	0	0	0	0	0	0	0	0	0	0	0	0	0	0	0	0	0	0	0	0	2	3	2
0	0	0	0	0	0	0	0	0	0	0	0	0	0	0	0	0	0	0	0	0	0	0	2	3	2
0	0	0	0	0	0	0	0	0	0	0	0	0	0	0	0	0	0	0	0	0	0	0	2	3	2
0	0	0	0	0	0	0	0	0	0	0	0	2	2	2	2	2	2	2	0	0	0	0	2	3	2
0	0	0	0	0	0	0	0	0	0	0	0	2	1	1	1	1	1	2	0	0	0	0	2	3	2
0	0	0	0	0	0	0	0	0	0	0	0	2	1	2	2	2	1	2	0	0	0	0	2	3	2
0	0	0	0	0	0	0	0	0	0	0	0	2	1	2	2	2	1	2	2	2	2	2	2	3	2
0	0	0	0	0	0	0	0	0	0	0	0	2	1	2	2	2	1	1	1	1	1	1	1	1	2
0	0	0	0	0	0	0	0	0	0	0	0	2	1	2	2	2	2	2	2	2	2	2	2	2	2
0	0	0	0	0	0	0	0	0	0	0	0	2	1	2	2	2	2	2	2	2	2	2	2	2	2
0	0	0	0	0	0	0	0	0	0	0	0	2	1	2	2	2	2	2	2	2	2	2	2	2	2
0	0	0	0	0	0	0	0	0	0	0	0	2	1	2	2	2	2	2	4	0	0	0	0	0	0
0	0	0	0	0	0	0	0	0	0	0	0	2	1	2	2	2	2	2	4	0	0	0	0	0	0
0	0	0	0	0	0	0	0	0	0	0	0	2	1	1	1	1	1	1	5	6	0	0	0	0	0
0	0	0	0	0	0	0	0	0	0	0	0	2	2	2	2	2	2	2	4	0	0	0	0	0	0
0	0	0	0	0	0	0	0	0	0	0	0	2	2	2	2	2	2	2	4	0	0	0	0	0	0